#######################################
# Syntax Coloring Map For ArduinoOPL2
#######################################

#######################################
# Datatypes (KEYWORD1)
#######################################

OPL2	KEYWORD1
OPL3	KEYWORD1
OPL3Duo	KEYWORD1
Operator	KEYWORD1
Instrument	KEYWORD1
Instrument4OP	KEYWORD1

#######################################
# Methods and Functions (KEYWORD2)
#######################################

begin	KEYWORD2
reset	KEYWORD2
createShadowRegisters	KEYWORD2
init	KEYWORD2
getChipRegister	KEYWORD2
getChannelRegister	KEYWORD2
getOperatorRegister	KEYWORD2
getRegisterOffset	KEYWORD2
setChipRegister	KEYWORD2
setChannelRegister	KEYWORD2
setOperatorRegister	KEYWORD2
getChipRegisterOffset	KEYWORD2
getChannelRegisterOffset	KEYWORD2
getOperatorRegisterOffset	KEYWORD2
write	KEYWORD2
getNumChannels	KEYWORD2
getNum4OPChannels	KEYWORD2
get4OPControlChannel	KEYWORD2
getFrequencyBlock	KEYWORD2
getFrequencyFNumber	KEYWORD2
getNoteFNumber	KEYWORD2
getFrequencyStep	KEYWORD2
playNote	KEYWORD2
playDrum	KEYWORD2
createInstrument	KEYWORD2
loadInstrument	KEYWORD2
getInstrument	KEYWORD2
getDrumInstrument	KEYWORD2
setInstrument	KEYWORD2
setDrumInstrument	KEYWORD2
createInstrument4OP	KEYWORD2
loadInstrument4OP	KEYWORD2
getInstrument4OP	KEYWORD2
setInstrument4OP	KEYWORD2
getWaveFormSelect	KEYWORD2
getTremolo	KEYWORD2
getVibrato	KEYWORD2
getMaintainSustain	KEYWORD2
getEnvelopeScaling	KEYWORD2
getMultiplier	KEYWORD2
getScalingLevel	KEYWORD2
getVolume	KEYWORD2
getChannelVolume	KEYWORD2
getAttack	KEYWORD2
getDecay	KEYWORD2
getSustain	KEYWORD2
getRelease	KEYWORD2
getFNumber	KEYWORD2
getFrequency	KEYWORD2
getBlock	KEYWORD2
getNoteSelect	KEYWORD2
getKeyOn	KEYWORD2
getFeedback	KEYWORD2
getSynthMode	KEYWORD2
getDeepTremolo	KEYWORD2
getDeepVibrato	KEYWORD2
getPercussion	KEYWORD2
getDrums	KEYWORD2
getWaveForm	KEYWORD2
setWaveFormSelect	KEYWORD2
setTremolo	KEYWORD2
setVibrato	KEYWORD2
setMaintainSustain	KEYWORD2
setEnvelopeScaling	KEYWORD2
setMultiplier	KEYWORD2
setScalingLevel	KEYWORD2
setVolume	KEYWORD2
setChannelVolume	KEYWORD2
setAttack	KEYWORD2
setDecay	KEYWORD2
setSustain	KEYWORD2
setRelease	KEYWORD2
setFNumber	KEYWORD2
setFrequency	KEYWORD2
setBlock	KEYWORD2
setNoteSelect	KEYWORD2
setKeyOn	KEYWORD2
setFeedback	KEYWORD2
setSynthMode	KEYWORD2
setDeepTremolo	KEYWORD2
setDeepVibrato	KEYWORD2
setPercussion	KEYWORD2
setDrums	KEYWORD2
setDrums	KEYWORD2
setWaveForm	KEYWORD2
isOPL3Enabled	KEYWORD2
setOPL3Enabled	KEYWORD2
is4OPChannelEnabled	KEYWORD2
set4OPChannelEnabled	KEYWORD2
setAll4OPChannelsEnabled	KEYWORD2
isPannedLeft	KEYWORD2
isPannedRight	KEYWORD2
setPanning	KEYWORD2
get4OPSynthMode	KEYWORD2
set4OPSynthMode	KEYWORD2
get4OPChannelVolume	KEYWORD2
set4OPChannelVolume	KEYWORD2

#######################################
# Instances (KEYWORD2)
#######################################

#######################################
# Constants (LITERAL1)
#######################################

PIN_LATCH	LITERAL1
PIN_ADDR	LITERAL1
PIN_RESET	LITERAL1
OPL2_NUM_CHANNELS	LITERAL1
OPL3_NUM_2OP_CHANNELS	LITERAL1
OPL3_NUM_4OP_CHANNELS	LITERAL1
OPL3DUO_NUM_2OP_CHANNELS	LITERAL1
OPL3DUO_NUM_4OP_CHANNELS	LITERAL1
NUM_4OP_CHANNELS_PER_UNIT	LITERAL1
CHANNELS_PER_BANK	LITERAL1
OPERATOR1	LITERAL1
OPERATOR2	LITERAL1
MODULATOR	LITERAL1
CARRIER	LITERAL1	LITERAL1
SYNTH_MODE_FM	LITERAL1
SYNTH_MODE_AM	LITERAL1
SYNTH_MODE_FM_FM	LITERAL1
SYNTH_MODE_FM_AM	LITERAL1
SYNTH_MODE_AM_FM	LITERAL1
SYNTH_MODE_AM_AM	LITERAL1
DRUM_BASS	LITERAL1
DRUM_SNARE	LITERAL1
DRUM_TOM	LITERAL1
DRUM_CYMBAL	LITERAL1
DRUM_HI_HAT	LITERAL1
DRUM_BITS_BASS	LITERAL1
DRUM_BITS_SNARE	LITERAL1
DRUM_BITS_TOM	LITERAL1
DRUM_BITS_CYMBAL	LITERAL1
DRUM_BITS_HI_HAT	LITERAL1
NOTE_C	LITERAL1
NOTE_CS	LITERAL1
NOTE_D	LITERAL1
NOTE_DS	LITERAL1
NOTE_E	LITERAL1
NOTE_F	LITERAL1
NOTE_FS	LITERAL1
NOTE_G	LITERAL1
NOTE_GS	LITERAL1
NOTE_A	LITERAL1
NOTE_AS	LITERAL1
NOTE_B	LITERAL1
NUM_OCTAVES	LITERAL1
NUM_NOTES	LITERAL1
NUM_DRUM_SOUNDS	LITERAL1
INSTRUMENT_DATA_PROGMEM	LITERAL1
INSTRUMENT_DATA_SRAM	LITERAL1
INSTRUMENT_TYPE_MELODIC	LITERAL1
INSTRUMENT_TYPE_BASS	LITERAL1
INSTRUMENT_TYPE_SNARE	LITERAL1
INSTRUMENT_TYPE_TOM	LITERAL1
INSTRUMENT_TYPE_CYMBAL	LITERAL1
INSTRUMENT_TYPE_HI_HAT	LITERAL1
